Add Share=أضف مجلد المشاركة
All files encrypted=جميع الملفات مشفرة
All files protected=جميع الملفات محمية
All files unprotected=جميع الملفات غير محمية
Allocation method=طريقة التخصيص
Array must be Started to view Shares=يجب أن تكون المصفوفة **قيد التشغيل** لعرض مجلدات المشاركة 
Automatically split any directory as required=تقسيم أي من المجلدات تلقائيًا كما هو مطلوب
Automatically split only the top five directory levels as required=التقسيم التلقائي للمستويات الخمسة الأوائل فقط كما هو مطلوب
Automatically split only the top four directory levels as required=التقسيم التلقائي للمستويات الأربعة الأوائل فقط كما هو مطلوب
Automatically split only the top level directory as required=التقسيم التلقائي للمستوى الأول فقط كما هو مطلوب
Automatically split only the top three directory levels as required=التقسيم التلقائي للمستويات الثلاث الأوائل فقط كما هو مطلوب
Automatically split only the top two directory levels as required=التقسيم التلقائي للمستويين الأوائلين فقط كما هو مطلوب
Comments=ملاحظات
Compute All=حساب الكل
Compute=حساب
Disk Shares=مشاركات القرص
Do not use reserved names=لا تستخدم الأسماء المحجوزة
Do not use pool names=لا تستخدم أسماء التجمع
Enable Copy-on-write=تمكين النسخ عند الكتابة
Enter a name for the share=أدخل اسمًا لمجلد المشاركة
Excluded disks=الأقراص المستبعدة
Export=تصدير
Fill-up=تعبئة
Free=شاغر
has been deleted=تم حذفه
HDD=القرص الصلب
High-water=مياه عالية
Included disks=الأقراص المضمنة
Invalid Characters=أحرف غير صالحة
Invalid share name=اسم مجلد المشاركة غير صالح
Manual do not automatically split directories=يدوي: لا تقم بالتقسيم التلقائي للمجلدات
Minimum free space=الحد الأدنى من المساحة الشاغرة
Missing share name=اسم مجلد المشاركة مفقود
Most-free=الأكثر شاغراً
Mover takes no action=الناقل لا يتخذ أي إجراء
Mover transfers files from array to cache=ينقل الناقل الملفات من المصفوفة إلى ذاكرة التخزين المؤقت
Mover transfers files from cache to array=ينقل الناقل الملفات من ذاكرة التخزين المؤقت إلى المصفوفة  
next user share=مجلد المشاركة للمستخدم التالي
Only=فقط
Prefer=مفضل
previous user share=مجلد المشاركة للمستخدم السابق
Read=قراءة
Recompute=إعادة حساب
Rule=
Select cache pool=حدد تجمع ذاكرة التخزين المؤقت
Set when adding new share only=تعيين عند إضافة مجلد المشاركة جديدة فقط
Share contains data=مجلد المشاركة يحتوي على بيانات
Share is empty=مجلد المشاركة فارغ
Share is outside the list of designated disks=مجلد المشاركة خارج قائمة الأقراص المعينة
Share Settings=إعدادات مجلد المشاركة
Share status=حالة مجلد المشاركة
Size=
Some or all files unencrypted=
Some or all files unprotected=
Split level=
SSD=محرك الأقراص ذي الحالة الصلبة
There are no exportable disk shares=
There are no exportable user shares=
Time Machine volume size limit=
Unknown encryption state=
Use cache pool for new filesdirectories=Use cache pool (for new files/directories)
User Shares=
Volume dbpath=
Write=
You cannot use the following within share names=
